NO ./texture/marble.xpm
SO ./texture/dalle.xpm
WE ./texture/hell.xpm
EA ./texture/brick.xpm


F 130,130,150
C 225,30,0


        1111111111111111111111111
        1000000000110000000000001
        101100000111000000000K001
        1001000000000000N00000001
111111111011000001110000000000001
100000000011000001110111110111111
11110111111111D11100000010001
11110111111111011101010010001
11000000110101011100000010001
10000000000000001100000010001
10000000000000001101010010001
1100000111010101111101111000111
11110111 1110101 101111010001
11111111 1111111 111111111111
